אב ואם - הורים
אב טיפוס - בנין אב
אבה, חפץ - רצה
אבוקה - לפיד
אבור - מכונף
אבזרי לחימה ונפץ - תחמושת
אבחנה - דיאגנוזה
אבטחת ישובים - אבטש
אבי אבנר - נר
אבי אברהם - תרח
אבי אהוד - גרא
אבי אהוד השופט - גרא
אבי אכילס - פלאוס
אבי ברית המועצות - לנין 
אבי דוד - ישי
אבי האב - סב; סבא
אבי הבעל - חם
אבי הושע - בארי
אבי המהפכה הירוקה - בורלוג
אבי הנצרות - ישו
אבי העורקים - אאורטה; ותין
אבי העם היווני - הלן
אבי הקומוניזם - קרל מרקס
אבי התישבות הציונות - רופין 
אבי חנוך - קין; ירד
אבי נח - למך
אבי עילם - שם
אבי פרויקט טנק המרכבה - ישראל טל
אבי רצפה - איה 
אבי שאול - קיש
אבי שמגר - ענת
אבי שמשון - מנוח 
אבי תורת האבולוציה - דרוין; דארוין
אביהם של קין והבל - אדם
אביו של בת שבע שמרד בדוד - בכרי 
אביו של הדג נמו - מרלין 
אביו של שמשון - מנוח
אביון - דל; רש; עני
אביזר הגיינה - טמפון
אביזר המשמש לצביעת קירות - רולר
אביזר הנועד לסגירת פתח - מנעול
אביזר כבד באנייה - עוגן
אביזר לגיטריסט - מפרט
אביזר לסידור השיער - מסרק
אביזר לשיער - מסרק
אביזר לתפיסת גלים - גלשן 
אביזר משחק - צעצוע
אביזר של נגר - מסמר
אבל - אך; ברם
אבן בניין - נרי
אבן בנין מצויה בארץ - נרי 
אבן גדולה - סלע
אבן גיר גבישית - שיש
אבן גיר קשה - דולומיט 
אבן געשית - בזלת 
אבן הנזרקת על פסלו של מרקורי - מרקוליס
אבן חול גירית - כורכר 
אבן חזקה וקשה - חלמיש
אבן חלקה - שיש
אבן חן - אופל
אבן חן יקרה - פנינה; יהלום
אבן טובה - ירקן; אכטיס; אקדח; פרוזג; אופל
אבן טיפין - נטיף
אבן כבידה לסתימת  קברים - גולל 
אבן לבנייה - נרי
אבן לכתישת זיתים - ממל
אבן מחצב - פצלת
אבן קשה מאוד - חלמיש
אבן שואבת - מגנט
אבני משחק - לגו
אבני פסיפס - טסרה
אבנים קטנות - חצץ
אבץ - צינק 
אבצס - מורסה
אבק ניסור - נסורת
אבקה של דבר שנשרף - אפר
אבקוס - חשבוניה
אבקת פחם - פיח
אבקת פרחים זכרית - פולן
אברזין - ברזנט 
אברקים - חותלות; מכנסיים
אג"ח - בונד
אגד מדבק - פלסטר
אגדה אנדרסן - בת הים הקטנה  
אגדי, דמיוני - לגנדרי 
אגדת ילדים - סינדרלה
אגואיסט - אנוכי
אגודה לקידום ילדים מפגרים - אקים 
אגודת ספורט בארץ - מכבי
אגודת ספורט בארץ (ר"ת) - ביתר
אגודת צעירים נוצרים - ימקא
אגוז אדמה - בוטן
אגוז הודו - נרגיל 
אגם - ימה
אגם באיטליה - קומו 
אגם באירופה - קונסטנן  
אגם בסקוטלנד - לוך נס
אגם ברמת הגולן - בריכת רם
אגם בשוויץ - לוקרנו  
אגר כוחות - נח
אגרטל - וזה
אדגיו - בשלווה
אדום - סמוק
אדום (צבע) מימי קדם - ששר 
אדום עז - כרמיל; תולע 
אדון - מר
אדון הנביאים - משה
אדון, שליט - רבון 
אדיש - אפתי; שווה לב 
אדישים - קרי מזג
אדם - איש; נש
אדם אהוב מאוד - יקיר
אדם אחר - זולת
אדם אנין טעם - גורמה
אדם בעל דחף חולני להצתת אש - פירומן
אדם גבה קומה - איש מידות
אדם גבוה מאד - כפח 
אדם הגון - ישר
אדם החש רדוף - פרנואיד
אדם היושב בכלא - אסיר
אדם הלוקה בנפשו - חולה רוח
אדם המאוהב בעצמו - נרקיסיסט
אדם המאייר ציורי הנפשה - אנימטור
אדם המאמין בקיום הא-ל - תאיסט
אדם המוחזק לשם סחיטה - בן ערובה 
אדם המעתיק משפה לשפה - מתורגמן
אדם המרגיש נרדף - פרנואיד
אדם המתעב את הבריות - מיזנטרופ
אדם העובד באופן עצמאי - פרילנסר
אדם השואף להשליט את שלטון הדת - קלריק
אדם השומר לעצמו משאב - מונע בר
אדם חופשי - בן חורין
אדם חלש הנתון בסכנה מתמדת - עלה נידף 
אדם טוב לב - יקר נפש 
אדם כלשהו - פלוני
אדם לעגני וסרקסטי - ציניקן
אדם מאמין - דתי
אדם מבוגר - איש
אדם מחוסר תרבות - פרא
אדם מחרחר ריב - איש מדון
אדם מתוח ולא שקט - עצבני
אדם מתנשא ויהיר - סנוב
אדם נכבד, אציל (כ"ח) - חר
אדם עשיר ונכבד - שע, שוע
אדם עשיר, נכבד - שע; שוע
אדם פרובינציאלי - קרתן 
אדם רגיש - עדין נפש
אדם רשע - זד
אדם שאומנותו יצירת כלי חרס מחומר - קדר
אדם שאין ערך למעשיו ולדבריו - עובר בטל
אדם שאינו נוטה לשינויים - שמרן
אדם שחוזה אסון - נביא זעם
אדם שיודעים מיהו - מכר
אדם שיושב בכלא - אסיר
אדם שלא התחתן - רווק
אדם שמן - בעל גוף
אדם שמסיע מכונית - נהג
אדם שמקצועו הכנת דברי מאפה - קונדיטור
אדם שמרוכז בעצמו בלבד - אגוצנטרי
אדם שמת באופן לא טבעי - הרוג
אדם שמתנגד לשינויים - שמרן
אדם שנוצל ע"י אחרים - קורבן
אדם שפל - עלוב נפש
אדמדם - חכליל 
אדמה - לס; עפר; כבול;  קרקע
אדמה מדברית - לס
אדמה מעובדת - שדמה
אדמה פורייה - עידית
אדמה קדושה - טרה סנקטה 
אדמוני - גינגי
אדמיניסטרטור - אמרכל
אדמיניסטרטיבי - מנהלי 
אדמיניסטרציה - מנהלה
אדמינסטרטור - מנהלן 
אדמינסטרציה - מנהלה
אדמירל בריטי - נלסון
אדמת הנגב - לס
אדרבה - היא הנותנת
אדריכל איטלקי - אלברטי 
אדרנל - יותרת הכליה
אדרת - מעיל
אדשוני - אפתי 
אהב, אהד - חיבב
אהבת החכמה - פילוסופיה
אהובן של אפרודיטה ופרספונה - אדוניס 
אהל אינדיאני - ויגום 
אהל אינדיאני דמוי חרוט - טיפי 
אהל מונגולי - יורטה 
אואזיס - נוה מדבר
אובד עצות - נבוך
אובדן הכרה לזמן קצר - סינקופה
אוביקט דומם - חפץ
אוביקטים המשמשים מודל לציור - טבע דומם 
אובליגטורי - מחייב
אובססיה - טירדון
אוברדרפט - משיכת יתר
אוברול - סרבל
אודישן - מבחן בד
אודם - סומק 
אוהד - מחבב
אוהד שרוף - מעריץ
אווז - ברנטה 
אוויל - טפש
אוויל, טיפש - כסיל
אווילי - טפשי
אוורור - ונטילציה
אוחז - תופס
אוחז בהגה - נהג
אוחז ברסן השלטון - מושל בכיפה
אוטו - מכונית
אוטובוס העוצר בכל תחנה - מאסף
אוטפוט - פלט 
אויב - צר; קם
אויב הדרדסים - גרגמל
אויב מר - צורר
אויבו של פיטר פן - הוק 
אוילי - נואל 
אוירון - מטוס
אוכל את בני מינו - קניבל 
אוכל בשר  - קרניבור
אוכל כל - אומניבור
אוכל לבהמות - קש; חציר; מספוא
אוכל נמלים באסיה ובאפריקה - פנגולין
אוכל נמלים באפריקה ובאסיה - פנגולין 
אוכל עשב - מלחך
אולי, אפשרי - יתכן
אולם - אבל
אולם להצגת יצירות אומנות - גלריה
אולם, אבל - אך
אולקוס - כיב; כיב קיבה
אומה - עם
אומלט - חביתה
אומלל - מסכן
אומלל, מסכן - חלך 
אומן - ארטיסט
אומנות קיפולי ניר - אוריגמי
אומני הרנסנס - דונטלו; דה וינצי 
אומץ לב - רהב
אומצה - סטייק
אומר-הן - יס מן
אומר בקול שקט - לוחש
אוניברסיטה בארה"ב - יל; ברקלי
אוניברסיטה בארץ - העברית; בר אילן; בן גוריון
אוניברסיטה בפריז - סורבון
אוניברסיטה בקונטיקט - יל
אוניברסיטה בקליפורניה - ברקלי 
אוניית המלחמה מהירה - משחתת
אונית חיל הים - אחי 
אונית מעפילים - סטרומה  
אוסטרקין - חרס
אוסילטור - מתנד 
אוסף הישגי אדם בחייו - רקורד
אוסף כתבים מתומצתים - חלקיט 
אוסף, לקט - מקבץ
אוסף. מקבץ - מלקט
אופטימלי - מושלם
אופי תוסס - מזג חם
אופייני - סגולי
אופיני לחיק הטבע - פסטורלי 
אופן - גלגל
אופנת ספורט - אדידס
אופציאלי - רשמי 
אופקי - מאוזן
אופרה של בטהובן - פידליו
אופרה של ביזה - כרמן 
אופרה של ורדי - ריגולוטו; נבוקו; פלסטף
אופרה של מוצארט - נישואי פיגארו; חליל הקסם; דון גובאני 
אופרה של רוסיני - הספר מסיביליה 
אופרה של ריכרד שטראוס - סאלומה 
אופרת רוק ישראלית - מאמי 
אוצר - מטמון 
אוקטגון - מתומן 
אוקטט - שמיניה 
אור בהיר - זוהר
אור גדול - זיו
אור חיוור לאחר השקיעה - דמדומים
אורבניזציה  - עיור
אורגזמה - אביונה
אורגיה - בכחנליה
אורח - קרוא; מבקר
אורח חיים - הוי
אורטריה של הנדל - המשיח 
אוריגינלי - מקורי
אוריינטלי - מזרחי
אורית - רדיום
אורך רוח - סבלנות
אורלוגין - שעון קיר
אורשינה - עוף חול בתלמוד 
אות - סימן
אות אנגלית - די; טי; יו; קיו
אות באנגלית - אי; בי; סי; די; גי; פי; טי; וי; זי; יו; דבליו
אות באנגלית - איי; קיי; קיו; אקס
אות באנגלית - אף; אל; אם; אן; או; אר; אס 
אות יוונית  - אלפא; ביתא; גמא; דלתא; אפסילון; זטא; אטא; תטא; יוטא; קפא; לאמבדא; מו (מיו); ני; קסי; פי; אומריקון; רו; סיגמא; פסי; אומגה
אות מוזיקלי - תו
אות ניצחון - וי
אות עברית - וו; מם; נון; אלף; גימל; סמך; עין
אות קלון - סטיגמה
אותיות השפתיים - בומף
אותנטי - מקורי
אז נחגג ליל הסדר - ערב פסח
אזוביון - לבנדר
אזור באפריקה - מגרב
אזור בארגנטינה - פמפס
אזור בארץ - בקעת הירדן
אזור בדרום צרפת - פרובנס
אזור במזרח התיכון - הסהר הפורה
אזור בסוריה - חורן 
אזור בעבר הירדן המזרחי - בשן 
אזור בצ'כיה  - בוהמיה 
אזור בצפון אירופה  - לפלנד 
אזור בצפון סקנדינביה - לפלנד
אזור גבוה - רמה
אזור גבוה אחיד - רמה
אזור היסטורי בספרד - בסטיליה
אזור הנמצא תחת פיקוח שוטר - מקוף 
אזור התיישבות בארץ - חבל עדולם
אזור ללא שיער - קרחת
אזור מישורי מוקף הרים - עמק
אזור נמוך מסביבתו - בקעה
אזור על הקרקפת ללא שיער - קרחת
אזור צחיח - מדבר; ישימון
אזור שטוח ואופקי - מישור
אזור תעשיה בנגב - רמת חובב
אזורים בעלי צמחיה שגדלה ללא מגע אדם  - יערות עד 
אזעקה - צופר
אזרח - תושב
אזרח של בירת איטליה - רומאי
אח - קמין
אח משה - אהרון
אחד האבות  - אברהם; יצחק; יעקב
אחד הזמנים - עבר; הוה; עתיד
אחד הטעמים - מר; מתוק; מלוח
אחד המינים - זכר; נקבה
אחד המקשים במקלדת - אנטר; טאב; רווח
אחד המשקעים - גשם; שלג; ברד
אחד הצאצאים - נין; בן; בת
אחד הצבעים - לבן; שחור; כחול; ירוק; אדום; כתום
אחד הצדדים - ימין; שמאל
אחד השברים - חצי; רבע; שליש; חמישית
אחד השוואים - נע; נח
אחד השופטים בתנ"ך - אהוד; גדעון; שמגר בן ענת
אחד התווים - דו; רה; מי; פה; סו; לה; סי
אחד התלמודים - בבלי; ירושלמי
אחד מהאחים מרקס - הרפו; גראוצו
אחדותי - אוניטרי 
אחוז מהרווח המחולק בין בעלי המניה - דיבידנד
אחוזת קרקע גדולה - לטיפונדיה
אחורי הגוף - גב
אחוריים - שת
אחות משה - מרים
אחי אברהם - הרן
אחי אשכול וממרא  - ענר 
אחיד - הומוגני
אחיה של גרטל - הנזל 
אחיו הבכור של הורדוס - פצאל 
אחיו של קין - הבל
אחיזת עיניים - להטוט
אחים אוספי אגדות - גרים 
אחים מיסדי רומא  - רמוס ורומולוס
אחראי למעשה רע - אשם
אחראי על קבוצת לובשי מדים - מפקד
אחראי, מופקד - ממונה
אחרון (ארמית) - בתרא 
אחרון בגאוני בבל  - האי 
אחרי - פוסט, בתר
אחרי הגוף - גב
אחרי הזמן שנקבע  - מאוחר
אחרי, פוסט - בתר
אחרית דבר - אפילוג
אחרית הימים - ימות המשיח
אחת האצבעות - זרת; בהן; קמיצה; אגודל
אחת הדמויות בקלפים - גק; מלך; מלכה
אחת הדתות - יהדות; נצרות; בודהיזם
אחת היבשות - אסיה; אפריקה
אחת הספרות - שש; תשע; עשר; אחד; אחת; ששה; חמש; שבע; שלוש; ארבע; שישה; שבעה; תשעה; עשרה; שמונה; שלושה; ארבעה; חמישה; שניים; שתיים
אחת התפילות - מנחה; מוסף; ערבית; מעריב; שחרית
אטב - מקל כביסה
אטום בעל מטען חשמלי - יון
אטום לחלוטין - הרמטי 
אטימולוגיה  - גזרון 
אטרופיה - דלדול 
אטריות ממזרח אסיה - נודלס
אי איטלקי קטן - אלבה; קפרי 
אי אינדונזי - יוה
אי אסטוני - רונו
אי באוקינוס הארקטי  - ורנגל; ויגץ 
אי באוקינוס ההודי - זנזיבר
אי באינדונזיה - יוה; סימטרה; רוטי; באלי
אי בדרום מזרח אסיה - טימור
אי בים התיכון - סיציליה
אי בסקוטלנד - יל
אי בפולינזיה הצרפתית - טהיטי 
אי בפילפינים - לוזון 
אי בריטי  - מאן 
אי בשוודיה - גוטלנד 
אי געשי באנטרקטיקה  - רוס 
אי גרמני בים הבלטי  - ריגן 
אי הסכמה - התנגדות
אי הצלחה, משגה - כשל
אי ודאות - ספק
אי יווני - מילוס; קורפו; לסבוס; תסוס 
אי יווני בים האגאי - מיקונוס
אי יפני - הונשו; קיושו; הוקאידו
אי לחוף ארה"ב  - ננטקט 
אי ליד אוסטרליה - טזמניה
אי ליד אוסטרליה  - טסמניה 
אי סדר - ברדק
אי סדר, בלגן  - כאוטי; ברדק 
אי ספרדי בים התיכון - מיורקה
אי צדק - עוול
אי ציות - מרי
אי רוסי במזרח - סחלין
אי שפיות - שגעון
אי תימני בים סוף - כמרן 
איבד את ההכרה לזמן קצר - התעלף
איבד מצבעו - דהה
איבדו מצבעם - דהו
איבוד תקווה - יאוש
איבר בגוף  - ראש; כבד
איבר בגף האשה - רחם; שחלות; נרתיק
איבר בחיה - זנב
איבר במערכת העיכול - קיבה
איבר בפה - לשון
איבר בפנים - פה; אף; עין
איבר בציפור  - מקור
איבר דוקרני בצמחים  - עוקץ 
איבר הבליעה  - לע
איבר ההנקה - שד
איבר החשיבה - מח
איבר הנקה - שד
איבר התנועה של דגים - סנפיר
איבר זוגי בגוף - יד; רגל; עין
איבר זכרי - פין; זרג
איבר חישה בראשם של חרקים - מחוש 
איבר חשוב בראש  - מח
איבר מלאכותי - פרוטזה
איבר נשי  - שחלה
איבר נשימה בדג - זים
איבר נשימה של דג - זים
איבר פנימי בגוף - מעי; כבד;  מוח; לבלב
איבר קטוע - גדם
איבר רביה בפרח - זיר 
איבר רביה זכרי  - אשך 
איבר רבייה - שחלה
איבר תנועה - גף
איברי ההנקה - שדים
איברי הנשימה - ריאות
איגוד סוחרים - גילדה
איגוד צעירי הנוצרים - ימקא
איגיון - נונסנס 
איגיון הומור אבסורדי - נונסנס
איגרת - מכתב
אידיאה - רעיון
אידיוט (עגה) - דגנרט
אידיוט, טיפש - דגנרט 
אידיומטי - ניבי
איום - נורא
איור משעשע ועוקצני - קריקטורה
איוש שחקנים לתפקידים אמנותיים - ליהוק
איזור שבין גן עדן לגיהנום - לימבו 
איזור שטוח - מישור
איזמל ניתוחים - לנסט 
איחד, צירף - מיזג
איחול - ברכה
איחול לפני פעולה - בהצלחה
איטי המוסיקה - לנטו
איטליה - ארץ המגף
איי תעלה אנגלית - גרסי 
אייל - ופוטי; יחמור; מושק; גואמל; אלק 
אייל באנדים - גואמל 
אייל באסיה - מושק; סיקה 
אייל בדרום אמריקה - פודו
אייל בקנדה - אלק 
אייל הצפון - קריבו
אייל מנוקד - יחמור
איים ליד ארגנטינה - פוקלנד
איים תחת שלטון בריטניה באוקינוס אטלנטי - פוקלנד 
איכות - טיב
איכות  - טיב
איכר - פלח; יוגב; חקלאי; עובד אדמה
איל הצפון - קריבו 
אילן - עץ
אילץ מישהו לעזוב את ארצו  - הגלה 
אימון ראשוני בצבא - טירונות
אימננטי - פנימי
אימפולס - דחף
אימפולסיבי - פרצני
אימפורט - יבוא
אימפורטר - יבואן
אימפרטור - קיסר
אימפרטור  - קיסר 
אימפריה קדומה - בבל; אשור
אימת - ודא; וידא
אין (ארמית) - לית
אין בו סכנה - בטוח
אין בו פחד - ללא חת
אין דרך יציאה - אין מוצא
אין זולתו - יחיד
אין חכם כבעליו - נסיון 
אין לו יסוד מציאותי - חסר שחר 
אין מה שישנה את המצב - בית דין לא יעזור
אין מי שחולק - לכל הדעות
אין עוד כמוהו - יחידי
אין, נעלם בתורכית - יוק 
אינבו - פלסבו
אינג'ניר - מהנדס
אינדוקטרינציה  - שטיפת מח 
אינדטיפיקציה  - זהוי 
אינדיקטור - לקמוס;  מחון
אינדקס - מדד
אינו בקרבת מקום - רחוק
אינו דו פרצופי - תוכו כברו
אינו דובר אמת - שקרן
אינו חף מפשע - אשם
אינו יכול להגיב  - חסר ישע 
אינו ירוק עד - נשיר 
אינו ישן - ער
אינו ליברלי - שמרן
אינו מומחה - הדיוט
אינו מוצא את דרכו - תועה
אינו מעורר עניין - משעמם
אינו מעיד על עיסתו - נחתום
אינו משתתף בהצבעה - נמנע
אינו נבדל במאומה מהאחר - זהה
אינו נוהג לעמוד על שלו - רך אופי 
אינו נוקט עמדה - נמנע
אינו נוקט צד - נמנע
אינו נוקט צד בהצבעה  - נמנע 
אינו עובד - נח; בטל
אינו פורה - עקר
אינטגריטי - יושרה 
אינטגרליות - אחדות 
אינטואיציה - בינת הלב; הבנת הלב
אינטרסול - בוידם
איניציאטור - יזם 
איניציאטיבה - יוזמה 
אינסטינקט - יצר
אינסטינקטיבי - יצרי 
אינסטלטור - שרברב
אינפנטילי - ילדותי
אינקובטור - חממית
אינקוגניטו - בעלום שם
איסוף יבול מהשדות - קציר
איסוף מידע בחשאי - רגול
איסוף פירות מהעצים - קטיף
איסור חברתי - טבו; טאבו
איסור מוחלט - טבו; טאבו
איסור פרסום בהליך משפטי (לטינית) - סוב יודיצה
איצטדיון - ריס 
איצטדיון בלונדון - ומבלי 
אירוע מוחי - שבץ
איש דת - רב
איש דת נוצרי - כומר
איש השלג  - יטי  
איש חוק בארה"ב - שריף
איש חצר המלוכה - חצרן 
איש טלוויזיה ורדיו ישראלי - רפי רשף
איש טלוויזיה ישראלי - דב גילהר
איש טלוויזיה ישראלי  - רפיק חלבי; עודד בן עמי
איש יחסי ציבור ישראלי - אייל ארד
איש כנופיית שודדים - בנדיט
איש מכירות - מוכרן 
איש מעשה (בלשון הדיבור) - ביצועיסט
איש עסקים ישראלי רוסי - גאידמק
איש עסקים, מעשירי ישראל - צדיק בינו
איש ערב - לורנס 
איש צבא - חיל
איש צעיר - עלם; בחור
איש צפרדע  - צוללן; אמודאי
איש שלג אגדי - יטי
אישה גברית - וירגו
אישה מעוברת  - הרה
אישה צעירה - עלמה
אישון העין - בבה 
אישור רשמי לחוק או למסמך - גושפנקה
אישור רשמי על הסמכה לתפקיד - כתב מנוי 
אישי - פרטי
אישיאס - נשית 
אישיות חושבת בעלת תודעה  - אוביקט 
איתן - חזק
איתנזיה - המתת חסד 
איתר - מצא
איתר יד ימינו - שמאלי
איתר, גילה - מצא
אך - רק
אכזרי - ברוטלי
אכיל לפי ההלכה - כשר
אכילה מרובה - זללנות
אכילה רבה - זלילה
אכילת חטיפים - נשנוש
אכל ברעבתנות - זלל
אכן - אומנם
אכסניה - מוטל
אכסניה לעניים  - הקדש 
אכסנייה - פונדק
אכסניית דרכים - פונדק
אל אשורי - אשימא
אל האהבה - ארוס 
אל האור החיים והיופי במיתולוגיה הסקנדינבית - בלדור 
אל האש הרומאי  - וולקן 
אל הודי  - וישני 
אל החורבן הבבלי - נרגל
אל החורבן והשאול הבבלי - נרגל
אל החלומות - מורפיוס 
אל הים ביוון - פוסידון
אל הים הרומי - נפטון
אל הינדואי - וישנו
אל הינדי - שיוה; וישנו
אל המלחמה הרומי - מרס 
אל הפריון - פריאפוס
אל הפריון היווני - פריאפוס
אל הרועים במיתולוגיה היוונית - פן; פאן
אל הרעם במיתולוגיה הנורדית  - תור
אל השאול היווני - הדס
אל השמש - אפולו 
אל השמש המצרי - אמון 
אל התחלות, הדלתות והמפתנים - ינוס 
אל יווני - פוסידון; קרונוס; אטלס; בכחוס
אל יווני חזק ויפה - אפולו
אל כפול פנים - יאנוס 
אל מול - בפני; כנגד
אל מיני - וגטטיבי 
אל מצרי - אמון; אדוניס; רע; סת 
אל פריון רומי - ליבר 
אל רועי הצאן ביוון הקדומה - פאן 
אל תצטער, אל תתרגז - אל יחר בעיניך
אל תתעקש - ותר
אלא רק - בלבד
אלבום של אביב גפן - שומקום
אלבום של דייר סטרייטס - אחים לנשק
אלבום של שלמה ארצי - ערב ערב
אלבינו - לבקן
אלבסטר - בהט 
אלגוריה - משל 
אלה - נבוט
אלה יוונית - הרה 
אלה כנענית  - ענת; עשתורת
אלה מעץ - נבוט
אלה פיניקית - אשתר
אלה רומאית של אש הכיריים  - וסטה 
אלה רומית - יונו 
אלוהי החושך הפרסי - אהרמין
אלומיניום - חמרן 
אלומת שיבולים קצרות - עומר 
אלונטית - מגבת 
אלונקה - נרוד 
אלוף - רבן
אלוף בצה"ל - דני מט
אלוף הארץ בשחמט - צרניאק 
אלוף העולם בשחמט - קאספרוד; אליוכין 
אלוף שחמט צ'כי - שטיניץ 
אלחוט - רדיו
אלחש - הרדים
אלטרואיסטי - זולתני
אלטרנטיבי - חלופי
אליל גורל קדמון - מני 
אליל השבט - טוטם
אליל שבט - טוטם 
אלילה כנענית - ענת
אלילי בית - תרפים
אלילת מות הודית  - קלי 
אליפות העולם בכדורגל - מונדיאל
אליפטי - סגלגל 
אלמוג - קורל 
אלמוני - פלוני; אנונימי
אלמן - ארמלי
אלף - שור 
אלף אלפים - מיליון
אלף מיליונים - מיליארד; ביליון
אלפית - פרומיל
אלפס - קלחת
אלפקה - גמל הצאן
אלפרד דרייפוס היה במאסר שם - אי השדים
אלרגיה - רגשת
אלת האהבה ופריון כנענית - עשתרת; אשתר 
אלת האושר ואהבה ההודית - לקשמי
אלת הדלתות המפתנים וההתחלות - ונוס
אלת היופי - אפרודיטה 
אלת המלחמה הכנענית - ענת
אלת הניצחון היוונית - ניקה 
אלת הנקמה ביוון - נמסיס
אלת העושר והאושר ההודית - לקשמי 
אלת הפרחים הרומית - פלורה 
אלת הפריון האכדית - אשתר
אלת הצדק והנקמה - נמסיס
אלת הצדק והנקמה היוונית - נמסיס
אלת הציד, פריון וצמיחה - דיאנה 
אלת הקשת בענן במיתולוגיה היוונית - איריס  
אלת הריב היוונית - אריס
אלת השמים המצרית הקדומה - חתחור 
אלת טבע מישנית - נימפה 
אלתור - אימפרוביזציה
אם אפולו וארטמיס - לטו 
אם האלים במיתולוגיה הקלטית - דנו
אם המרגלית - דר
אם הפנינה - דר
אם ישמעאל - הגר
אם כל חי - חוה
אם כן - ובכן
אם לא - אלמלא
אמבוש - מארב 
אמביוולנטי - דו ערכי
אמביציה - שאפתנות
אמביציוזי - שאפתן 
אמו של אדוניה - חגית
אמו של אחזיה - עתליה 
אמו של ישמעאל - הגר
אמו של מנשה - חפציבה
אמו של משה - יוכבד
אמו של משה רבנו - יוכבד
אמולסיה  - תחליב
אמונה - דת
אמוניאק - נשדור
אמוציה - רגש
אמוציונלי - רגשי
אמורטיזציה - בלאי 
אמייל - תזגיג 
אמיץ - עז; נועז; עז נפש
אמיץ מאד  - לבלי חת 
אמירות - נסיכות
אמירת שלום בערבית - אהלן
אמיתה  - אקסיומה 
אמיתי - נכון
אמן - ארטיסט
אמן בידור ישראלי - נאור ציון; טוביה צפיר
אמן ויכוח - דיאלקטיקן
אמן ישראלי - אגם 
אמן כלי חרס - קדר
אמן מתקופת הרנסנס - מיכלאנגלו; דה וינצי
אמנה - ברית
אמנות לחימה אולימפית - גודו
אמנות לחימה ברזילאית - קפואירה
אמנות לחימה יפנית - גודו; קרטה; קונג פו
אמנית ישראלית - אילנה גור
אמנם - אכן 
אמנם כך - אכן
אמנם כן - אכן
אמפטיה - הזדהות 
אמפיבי - דו חי 
אמצע - לב; מרכז; טבור
אמצע החודש  - טו
אמצע חודש - טו
אמצעי הכרעה בין צדדים מסוכסכים - בוררות
אמצעי כלכלי - משאב
אמצעי להזרמת מים חמים - דוד שמש
אמצעי להעברת מכתבים בעבר - יונת דאר
אמצעי לחימה - נשק
אמצעי לפיזור הפגנות - גז מדמיע
אמצעי מניעה - קונדום
אמצעי משיכה ולכידה - פתיון
אמצעי ספרותי - דמוי;  השאלה 
אמצעי תאורה - נר; פנס
אמצעי תחבורה - כלי רכב
אמצעי תחבורה להעברת סחורות - רכבת משא
אמצעי תשלום מקובל וחוקי - מטבע עובר לסוחר
אמר דברי קינה - ספד
אמר דברים מתוך מרמור וכעס - רטן
אמר, דיבר - סח
אמרגן ומפיק ישראלי בעבר - פשנל 
אמרכל - אדמיניסטרטור
אמרת כנף - פתגם 
אמת מים - ויאדוקט
אמת סף - מזוזה
אמתחת - סל; שק
אנא - בבקשה
אנגינה פקטוריס - תעוקת הלב 
אנדרטה - יד
אנוכי - אגואיסט
אנונימי  - אלמוני
אנוש - בן אדם
אנזים - תסס
אנזים המצוי במיץ הקיבה - רנין
אנטי - נגד
אנטיגן - אנגד 
אנטילופה  - ראם; קודו 
אנטילופה באפריקה - קאנה 
אנטילופה במדבר סהרה - דישון 
אני אוסר - וטו
אני לא - איני; אינני
אני מקשיב היטב - כולי אוזן
אניגמה - חידה
אניגמטי - חידתי 
אניית מעפילים - אקסודוס; סטרומה
אנכי  - ורטיקלי
אנלוגיה - הקש
אנסטזיה  - אלחוש 
אנסמבל - הרכב 
אנציקלופדיה - מכלל 
אנציקלופדיה ידועה באנגלית - בריטניקה
אנקול - וו
אנשובי - עפין 
אנשים הבולטים באופן מיוחד - יחידי סגולה
אנשים לא מעטים - רבים
אנשים ספורים - מתי מעט
אנשים שלא אחראים על מעשיהם - חרש שוטה וקטן
אנתרקס - גחלת
אסדת נחיתה - נחתת 
אסון - איד; צרה
אסטמה - (ראה אסתמה)
אסטרולוג  - הובר 
אסטרולוג צרפתי נודע - נוסטרדאמוס
אסטרונאוט אמריקאי - גלן; ארמסטרונג
אסטרונאוט אמריקני - גלן; ארמסטרונג
אסטרונואוט אמריקאי - גלן
אסטרונום - תוכן 
אסטרונום גרמני - קפלר 
אסטרונום דני - ברהה 
אסיה, אפריקה או אירופה - יבשת
אסיומה - אמיתה
אסיפה כללית של החברים - מליאה
אסיפת גדולי הכנסיה ונציגיה  - סינוד
אסיפת המונים - עצרת עם
אסכולה - בית מדרש
אסכולה בודהיסטית יפנית - זן
אסכולת תאטרון יפנית - נו
אסכולת תיאטרון יפני  - נו 
אסכלה - מנגל; גריל 
אסף, צבר - אגר
אספה המונית - עצרת
אספלנית - פלסטר
אספקט - הבט; היבט; בחינה
אספקלריה - ראי
אסקופה - סף
אסקטי - סגפני
אסקפיזם - בורחנות
אסתמה - קצרת; גנחת
אף - גם
אף הפיל - חדק
אף על פי כן - יחד עם זאת
אף פעם בעבר - לעולם לא
אפודת נשים קצרה - בולרו
אפוטרופוס - חסות
אפוס לאומי גרוזיני - עוטה עור הנמר
אפיגרם - מכתב; מכתם 
אפידמיה - מגפה 
אפיון כללי פשטני - סטריאטיפ 
אפילוג - סוף דבר 
אפיפית - ופל
אפיק מים בשמורת עין גדי - נחל דוד
אפיק מים גדול - נהר
אפיק מים טבעי - נהר
אפיק מים שזורם כל השנה - נחל איתן
אפיק מים שנשפך לים המלח - נחל קדרון
אפיקורוס - מין; כופר
אפיקורוס, כופר - מין
אפל - חשוך
אפלה מוחלטת - חושך מצרים
אפליקציה - ישום 
אפנת מעלי התעמלות - ריבאק
אפקט - פעלול
אפקטיבי - יעיל
אפרופו - אגב; דרך אגב